111111111111111111111111111111
11111000000000PE00000000000011
111111110000000000000000000111
11111110000000000000000C000001
111111111111111111111111111111
