11111111111
11100P00111
111E00C1111
11111111111
