11111111111
11111111111
11E00001111
11000000001
11000000001
11000000011
11111000001
11100000011
11111100011
111111C0C11
11000000011
11000000011
11000P11111
11111111111
