111111111111
11AAAAAAAAA1
11111PEC0111
111111111111
