111111111111111111
100000000000000001
1111111111PEC11111
111111111111111111
       1
